1 3 3 3 3 3 3 3 3 3 3 3 3 3 3 3 3 3 3 3
1 1 1 1 1 1 1 1 1 1 1 1 1 1 1 1 1 1 1 3
3 0 0 0 0 0 0 0 0 1 1 1 0 0 0 0 0 0 0 3
3 1 1 1 1 1 1 1 1 1 1 1 1 1 1 1 1 1 1 3
3 0 1 1 1 1 1 1 1 1 1 1 1 1 1 1 1 1 0 3
3 0 1 1 1 1 1 1 1 1 1 1 1 1 1 1 1 1 0 3
3 1 1 1 1 1 1 1 1 1 1 1 1 1 1 1 1 1 1 3
3 0 1 1 1 1 2 2 2 2 2 2 1 1 1 1 1 1 0 3
3 0 1 1 1 1 2 2 2 2 2 2 1 1 1 1 1 1 0 3
3 0 1 1 1 1 2 2 2 2 2 2 1 1 1 1 1 1 0 3
3 1 1 1 1 1 2 2 2 2 2 2 1 1 1 1 1 1 1 3
3 1 1 1 1 1 2 2 2 2 2 2 1 1 1 1 1 1 1 3
3 0 1 1 1 1 2 2 4 2 2 2 1 1 1 1 1 1 0 3
3 0 1 1 1 1 1 1 1 1 1 1 1 1 1 1 1 1 0 3
3 0 1 1 1 1 1 1 1 1 1 1 1 1 1 1 1 1 0 3
3 0 1 1 1 1 1 1 1 1 1 1 1 1 1 1 1 1 0 3
3 1 1 3 3 3 3 3 3 3 3 3 3 3 3 3 1 1 1 3
3 1 1 1 1 1 1 1 1 1 1 1 1 1 1 1 1 1 1 3
3 1 1 1 1 1 1 1 1 1 1 1 1 1 1 1 1 1 1 3
3 3 3 3 3 3 3 3 3 3 3 3 3 3 3 3 3 3 3 3
END_MAP
Weapon,Axe,1,1,2,0
Armor,Armor,10,5,3,0
Armor,Golden Armor,10,5,4,0
Weapon,Golden Sword,10,5,6,0
Potion,Apple,1,0,1
Potion,Orange,2,1,1
END_ITEM
Boss,Dragon,200,40,20,6,10,10
END_MONSTER